acollign = Alexandre COLLIGNON <alexandre@collign.net>
adslakeside = adslakeside
afloom = Anders Hammar <anders@hammar.net>
agwilliams1000
aheritier = aheritier
akarasulu = akarasulu
aramirez = aramirez
arsenalist = arsenalist
averet = averet
baptiste = Baptiste Mathus <batmat@batmat.net>
benjones.selera = benjones.selera
bentmann = bentmann
bimargulies = bimargulies
bob = bob
boba = boba
bokken = Brett Okken <brett.okken.os@gmail.com>
brett = brett
brianfox = brianfox
brozow = brozow
cameronbraid = cameronbraid
carlos = carlos
cberry = cberry
charlie.collins = charlie.collins
chirino = chirino
chris = chris
christiangasser = christiangasser
dandiep = dandiep
dantran = Dan Tran <dantran@gmail.com>
darasan = darasan
david = David J. M. Karlsen <david@davidkarlsen.com>
dennisl = Dennis Lundberg <dennisl@apache.org>
dhawkins = dhawkins
dholroyd = dholroyd
dirk.laessig = dirk.laessig
djencks = djencks
dsimonek = dsimonek
dvicente72
eburghar = eburghar
ehsavoie = ehsavoie
eirbjo = eirbjo
epunzalan = epunzalan
eredmond = eredmond
ervalerio = ervalerio
evenisse = evenisse
fabemn = Fabrice Bellingard <bellingard@apache.org>
fgiust = fgiust
fredcooke = fredcooke
gjoseph = gjoseph
gleclaire = gleclaire
godin = Evgeny Mandrikov <godin@apache.org>
gruenebe = gruenebe
handyande = handyande
hboutemy = Hervé Boutemy <hboutemy@apache.org>
henryju = Julien Henry <henryju@yahoo.fr>
hermod = hermod
huntc = huntc
james.w.dumay = james.w.dumay
jboynes = jboynes
jdcasey = jdcasey
jdlandsh = jdlandsh
jeanlaurent = jeanlaurent
jesse = jesse
jgenender = jgenender
jglick = Jesse Glick <jglick@cloudbees.com>
jieryn = jieryn
jimisola = jimisola
jmz = jmz
joakime = joakime
jochen = Jochen Wiedmann <jochen.wiedmann@gmail.com>
joerg.hohwiller = joerg.hohwiller
jonnio = jonnio
jponge = Julien Ponge <julien@ponge.org>
jreyes = jreyes
jruiz = jruiz
jstrachan = jstrachan
jtolentino = jtolentino
jubu = jubu
jvanzyl = jvanzyl
kaare = kaare
kbravo = kbravo
kenney = kenney
khmarbaise = Karl Heinz Marbaise <khmarbaise@apache.org>
kismet = kismet
kohsuke = kohsuke
kristian = kristian
krosenvold = Kristian Rosenvold <krosenvold@apache.org>
lacostej = lacostej
lars3loff
lennartj = Lennart Jörelid <lj@jguru.se>
maguro = maguro
marceloverdijk = marceloverdijk
mark = mark
mauro = mauro
mfriedenhagen = Mirko Friedenhagen <mfriedenhagen@apache.org>
michal = michal
mkleint = Milos Kleint <mkleint@gmail.com>
mperham = mperham
mward = mward
ndeloof = ndeloof
oching = oching
olamy = Olivier Lamy <olamy@apache.org>
pgier = pgier
pikus = pikus
pkernevez = pkernevez
ptab = ptab
rafale = rafale
rahul = rahul
Rahul = Rahul
rfscholte = Robert Scholte <rfscholte@apache.org>
rickard.v.essen = Rickard von Essen <rickard.von.essen@gmail.com>
romale = romale
root = root
russgold = russgold
sanlavre = sanlavre
sbv = sbv
schristou88
scryan = scryan
seidinger = seidinger
sgoeschl = sgoeschl
sheadrick = sheadrick
sherriff = sherriff
shinobu = shinobu
shinsuke = shinsuke
simon.brandhof = Simon Brandhof <simon.brandhof@sonarsource.com>
slonopotamus = slonopotamus
snicoll = snicoll
soelvpil = soelvpil
stefanbirkner = Stefan Birkner <mail@stefan-birkner.de>
stephenconnolly = Stephen Connolly <stephen.alan.connolly@gmail.com>
stimpy = stimpy
struberg = struberg
tastle = tastle
t.broyer = t.broyer
tchemit = Tony Chemit <tchemit@apache.org>
tcurdt = tcurdt
thragor = thragor
tobrien = tobrien
tom = tom
topping = topping
trygvis = Trygve Laugstøl <trygvis@inamo.no>
user57
vmassol = Vincent Massol <vmassol@apache.org>
vsiveton = Vincent Siveton <vsiveton@apache.org>
wfay = wfay
wguttmn = Werner Guttmann <werner.guttmann@gmx.net>
zznate = zznate
